$pitchshiftrange 0

crash/glass	sounds/GLASSCRK.ogg
crash/curb	sounds/CURB.ogg
brutal/ezmodo	sounds/EASYMODO.ogg

voice/default/death1      	sounds/voice/default/death1.ogg
voice/default/death2      	sounds/voice/default/death2.ogg
voice/default/death3      	sounds/voice/default/death3.ogg
voice/default/death4      	sounds/voice/default/death4.ogg
voice/default/death5      	sounds/voice/default/death5.ogg
voice/default/fightstart1 	sounds/voice/default/fightstart1.ogg
voice/default/fightstart2 	sounds/voice/default/fightstart2.ogg
voice/default/fightstart3 	sounds/voice/default/fightstart3.ogg
voice/default/fightstart4 	sounds/voice/default/fightstart4.ogg
voice/default/fightstart5 	sounds/voice/default/fightstart5.ogg
voice/default/fightstart6 	sounds/voice/default/fightstart6.ogg
voice/default/fightstart7 	sounds/voice/default/fightstart7.ogg
voice/default/fightstart8 	sounds/voice/default/fightstart8.ogg
voice/default/fightstart9 	sounds/voice/default/fightstart9.ogg
voice/default/fightstart10	sounds/voice/default/fightstart10.ogg
voice/default/fightstart11	sounds/voice/default/fightstart11.ogg
voice/default/fightstart12	sounds/voice/default/fightstart12.ogg
voice/default/fightstart13	sounds/voice/default/fightstart13.ogg
voice/default/fightstart14	sounds/voice/default/fightstart14.ogg
voice/default/fightstart15	sounds/voice/default/fightstart15.ogg
voice/default/fightstart16	sounds/voice/default/fightstart16.ogg
voice/default/fightstart17	sounds/voice/default/fightstart17.ogg
voice/default/fightstart18	sounds/voice/default/fightstart18.ogg
voice/default/fightstart19	sounds/voice/default/fightstart19.ogg
voice/default/fightstart20	sounds/voice/default/fightstart20.ogg
voice/default/fightstart21	sounds/voice/default/fightstart21.ogg
voice/default/findsecret1 	sounds/voice/default/findsecret1.ogg
voice/default/findsecret2 	sounds/voice/default/findsecret2.ogg
voice/default/findsecret3 	sounds/voice/default/findsecret3.ogg
voice/default/findsecret4 	sounds/voice/default/findsecret4.ogg
voice/default/findsecret5 	sounds/voice/default/findsecret5.ogg
voice/default/findsecret6 	sounds/voice/default/findsecret6.ogg
voice/default/findsecret7 	sounds/voice/default/findsecret7.ogg
voice/default/findsecret8 	sounds/voice/default/findsecret8.ogg
voice/default/findsecret9 	sounds/voice/default/findsecret9.ogg
voice/default/findsecret10	sounds/voice/default/findsecret10.ogg
voice/default/findsecret11	sounds/voice/default/findsecret11.ogg
voice/default/findsecret12	sounds/voice/default/findsecret12.ogg
voice/default/findsecret13	sounds/voice/default/findsecret13.ogg
voice/default/getweapon1  	sounds/voice/default/getweapon1.ogg
voice/default/getweapon2  	sounds/voice/default/getweapon2.ogg
voice/default/getweapon3  	sounds/voice/default/getweapon3.ogg
voice/default/getweapon4  	sounds/voice/default/getweapon4.ogg
voice/default/getweapon5  	sounds/voice/default/getweapon5.ogg
voice/default/getweapon6  	sounds/voice/default/getweapon6.ogg
voice/default/getweapon7  	sounds/voice/default/getweapon7.ogg
voice/default/getweapon8  	sounds/voice/default/getweapon8.ogg
voice/default/getweapon9  	sounds/voice/default/getweapon9.ogg
voice/default/getweapon10 	sounds/voice/default/getweapon10.ogg
voice/default/getweapon11 	sounds/voice/default/getweapon11.ogg
voice/default/getweapon12 	sounds/voice/default/getweapon12.ogg
voice/default/getweapon13 	sounds/voice/default/getweapon13.ogg
voice/default/grunt1      	sounds/voice/default/grunt1.ogg
voice/default/grunt2      	sounds/voice/default/grunt2.ogg
voice/default/grunt3      	sounds/voice/default/grunt3.ogg
voice/default/grunt4      	sounds/voice/default/grunt4.ogg
voice/default/grunt5      	sounds/voice/default/grunt5.ogg
voice/default/grunt6      	sounds/voice/default/grunt6.ogg
voice/default/hipain1     	sounds/voice/default/hipain1.ogg
voice/default/hipain2     	sounds/voice/default/hipain2.ogg
voice/default/hipain3     	sounds/voice/default/hipain3.ogg
voice/default/hipain4     	sounds/voice/default/hipain4.ogg
voice/default/hipain5     	sounds/voice/default/hipain5.ogg
voice/default/locked1     	sounds/voice/default/locked1.ogg
voice/default/locked2     	sounds/voice/default/locked2.ogg
voice/default/locked3     	sounds/voice/default/locked3.ogg
voice/default/locked4     	sounds/voice/default/locked4.ogg
voice/default/lopain1     	sounds/voice/default/lopain1.ogg
voice/default/lopain2     	sounds/voice/default/lopain2.ogg
voice/default/lopain3     	sounds/voice/default/lopain3.ogg
voice/default/lopain4     	sounds/voice/default/lopain4.ogg
voice/default/lopain5     	sounds/voice/default/lopain5.ogg
voice/default/mapstart1   	sounds/voice/default/mapstart1.ogg
voice/default/mapstart2   	sounds/voice/default/mapstart2.ogg
voice/default/mapstart3   	sounds/voice/default/mapstart3.ogg
voice/default/mapstart4   	sounds/voice/default/mapstart4.ogg
voice/default/mapstart5   	sounds/voice/default/mapstart5.ogg
voice/default/mapstart6   	sounds/voice/default/mapstart6.ogg
voice/default/mapstart7   	sounds/voice/default/mapstart7.ogg
voice/default/mapstart8   	sounds/voice/default/mapstart8.ogg
voice/default/mapstart9   	sounds/voice/default/mapstart9.ogg
voice/default/mapstart10  	sounds/voice/default/mapstart10.ogg
voice/default/mapstart11  	sounds/voice/default/mapstart11.ogg
voice/default/mapstart12  	sounds/voice/default/mapstart12.ogg
voice/default/mapstart13  	sounds/voice/default/mapstart13.ogg
voice/default/mapstart14  	sounds/voice/default/mapstart14.ogg
voice/default/pain1       	sounds/voice/default/pain1.ogg
voice/default/pain2       	sounds/voice/default/pain2.ogg
voice/default/pain3       	sounds/voice/default/pain3.ogg
voice/default/pain4       	sounds/voice/default/pain4.ogg
voice/default/pain5       	sounds/voice/default/pain5.ogg
voice/default/pain6       	sounds/voice/default/pain6.ogg
voice/default/puzzfail1   	sounds/voice/default/puzzfail1.ogg
voice/default/puzzfail2   	sounds/voice/default/puzzfail2.ogg
voice/default/puzzfail3   	sounds/voice/default/puzzfail3.ogg
voice/default/puzzfail4   	sounds/voice/default/puzzfail4.ogg
voice/default/puzzfail5   	sounds/voice/default/puzzfail5.ogg
voice/default/puzzfail6   	sounds/voice/default/puzzfail6.ogg
voice/default/puzzsucc1   	sounds/voice/default/puzzsucc1.ogg
voice/default/puzzsucc2   	sounds/voice/default/puzzsucc2.ogg
voice/default/puzzsucc3   	sounds/voice/default/puzzsucc3.ogg
voice/default/puzzsucc4   	sounds/voice/default/puzzsucc4.ogg
voice/default/puzzsucc5   	sounds/voice/default/puzzsucc5.ogg
voice/default/scorekill1  	sounds/voice/default/scorekill1.ogg
voice/default/scorekill2  	sounds/voice/default/scorekill2.ogg
voice/default/scorekill3  	sounds/voice/default/scorekill3.ogg
voice/default/scorekill4  	sounds/voice/default/scorekill4.ogg
voice/default/scorekill5  	sounds/voice/default/scorekill5.ogg
voice/default/scorekill6  	sounds/voice/default/scorekill6.ogg
voice/default/scorekill7  	sounds/voice/default/scorekill7.ogg
voice/default/scorekill8  	sounds/voice/default/scorekill8.ogg
voice/default/scorekill9  	sounds/voice/default/scorekill9.ogg
voice/default/scorekill10 	sounds/voice/default/scorekill10.ogg
voice/default/scorekill11 	sounds/voice/default/scorekill11.ogg
voice/default/scorekill12 	sounds/voice/default/scorekill12.ogg
voice/default/scorekill13 	sounds/voice/default/scorekill13.ogg
voice/default/scorekill14 	sounds/voice/default/scorekill14.ogg
voice/default/scorekill15 	sounds/voice/default/scorekill15.ogg
voice/default/scorekill16 	sounds/voice/default/scorekill16.ogg
voice/default/scorekill17 	sounds/voice/default/scorekill17.ogg
voice/default/scorekill18 	sounds/voice/default/scorekill18.ogg
voice/default/scorekill19 	sounds/voice/default/scorekill19.ogg
voice/default/scorekill20 	sounds/voice/default/scorekill20.ogg
voice/default/scorekill21 	sounds/voice/default/scorekill21.ogg
voice/default/scorekill22 	sounds/voice/default/scorekill22.ogg
voice/default/scorekill23 	sounds/voice/default/scorekill23.ogg
voice/default/scorekill24 	sounds/voice/default/scorekill24.ogg
voice/default/scorekill25 	sounds/voice/default/scorekill25.ogg
voice/default/scorekill26 	sounds/voice/default/scorekill26.ogg
voice/default/scorekill27 	sounds/voice/default/scorekill27.ogg
voice/default/gethit1  		sounds/voice/default/gethit1.ogg
voice/default/gethit2  		sounds/voice/default/gethit2.ogg
voice/default/gethit3  		sounds/voice/default/gethit3.ogg
voice/default/gethit4  		sounds/voice/default/gethit4.ogg
voice/default/gethit5  		sounds/voice/default/gethit5.ogg
voice/default/gethit6  		sounds/voice/default/gethit6.ogg
voice/default/gethit7  		sounds/voice/default/gethit7.ogg
voice/default/gethit8  		sounds/voice/default/gethit8.ogg
voice/default/gethit9  		sounds/voice/default/gethit9.ogg
voice/default/gethit10 		sounds/voice/default/gethit10.ogg
voice/default/gethit11 		sounds/voice/default/gethit11.ogg
voice/default/gethit12 		sounds/voice/default/gethit12.ogg
voice/default/gethit13 		sounds/voice/default/gethit13.ogg
voice/default/gethit14 		sounds/voice/default/gethit14.ogg
voice/default/gethit15 		sounds/voice/default/gethit15.ogg
voice/default/gethit16 		sounds/voice/default/gethit16.ogg
voice/default/gethit17 		sounds/voice/default/gethit17.ogg
voice/default/gethit18 		sounds/voice/default/gethit18.ogg
voice/default/friendhit1	sounds/voice/default/friendhit1.ogg
voice/default/friendhit2	sounds/voice/default/friendhit2.ogg
voice/default/friendhit3	sounds/voice/default/friendhit3.ogg
voice/default/friendhit4	sounds/voice/default/friendhit4.ogg
voice/default/friendhit5	sounds/voice/default/friendhit5.ogg
voice/default/friendhit6	sounds/voice/default/friendhit6.ogg
voice/default/friendhit7	sounds/voice/default/friendhit7.ogg
voice/default/greet1		sounds/voice/default/greet1.ogg
voice/default/greet2		sounds/voice/default/greet2.ogg
voice/default/greet3		sounds/voice/default/greet3.ogg
voice/default/greet4		sounds/voice/default/greet4.ogg
voice/default/greet5		sounds/voice/default/greet5.ogg
voice/default/greet6		sounds/voice/default/greet6.ogg
voice/default/greet7		sounds/voice/default/greet7.ogg
voice/default/hitfriend1	sounds/voice/default/hitfriend1.ogg
voice/default/hitfriend2	sounds/voice/default/hitfriend2.ogg
voice/default/hitfriend3	sounds/voice/default/hitfriend3.ogg
voice/default/ragekit1		sounds/voice/default/ragekit1.ogg
voice/default/ragekit2		sounds/voice/default/ragekit2.ogg
voice/default/ragekit3		sounds/voice/default/ragekit3.ogg
voice/default/ragekit4		sounds/voice/default/ragekit4.ogg
voice/default/ragekit5		sounds/voice/default/ragekit5.ogg
voice/default/ragekit6		sounds/voice/default/ragekit6.ogg
voice/default/koraxgreet1	sounds/voice/default/koraxgreet1.ogg
voice/default/koraxgreet2	sounds/voice/default/koraxgreet2.ogg
voice/default/koraxgreet3	sounds/voice/default/koraxgreet3.ogg
voice/default/koraxgreet4	sounds/voice/default/koraxgreet4.ogg
voice/default/koraxgreet5	sounds/voice/default/koraxgreet5.ogg
voice/default/koraxgreet6	sounds/voice/default/koraxgreet6.ogg
voice/default/koraxgreet7	sounds/voice/default/koraxgreet7.ogg
voice/default/koraxgreet8	sounds/voice/default/koraxgreet8.ogg
voice/default/koraxgreet9	sounds/voice/default/koraxgreet9.ogg
voice/default/koraxgreet10	sounds/voice/default/koraxgreet10.ogg
voice/default/koraxgreet11	sounds/voice/default/koraxgreet11.ogg
voice/default/koraxgreet12	sounds/voice/default/koraxgreet12.ogg
voice/default/koraxgreet13	sounds/voice/default/koraxgreet13.ogg
voice/default/koraxblood1	sounds/voice/default/koraxblood1.ogg
voice/default/koraxblood2	sounds/voice/default/koraxblood2.ogg
voice/default/koraxblood3	sounds/voice/default/koraxblood3.ogg
voice/default/koraxblood4	sounds/voice/default/koraxblood4.ogg
voice/default/koraxblood5	sounds/voice/default/koraxblood5.ogg
voice/default/koraxblood6	sounds/voice/default/koraxblood6.ogg
voice/default/koraxblood7	sounds/voice/default/koraxblood7.ogg
voice/default/koraxblood8	sounds/voice/default/koraxblood8.ogg
voice/default/koraxblood9	sounds/voice/default/koraxblood9.ogg
voice/default/koraxblood10	sounds/voice/default/koraxblood10.ogg
voice/default/koraxblood11	sounds/voice/default/koraxblood11.ogg
voice/default/koraxblood12	sounds/voice/default/koraxblood12.ogg
voice/default/koraxblood13	sounds/voice/default/koraxblood13.ogg
voice/default/koraxgame1	sounds/voice/default/koraxgame1.ogg
voice/default/koraxgame2	sounds/voice/default/koraxgame2.ogg
voice/default/koraxgame3	sounds/voice/default/koraxgame3.ogg
voice/default/koraxgame4	sounds/voice/default/koraxgame4.ogg
voice/default/koraxgame5	sounds/voice/default/koraxgame5.ogg
voice/default/koraxgame6	sounds/voice/default/koraxgame6.ogg
voice/default/koraxgame7	sounds/voice/default/koraxgame7.ogg
voice/default/koraxgame8	sounds/voice/default/koraxgame8.ogg
voice/default/koraxgame9	sounds/voice/default/koraxgame9.ogg
voice/default/koraxgame10	sounds/voice/default/koraxgame10.ogg
voice/default/koraxgame11	sounds/voice/default/koraxgame11.ogg
voice/default/koraxgame12	sounds/voice/default/koraxgame12.ogg
voice/default/koraxgame13	sounds/voice/default/koraxgame13.ogg
voice/default/koraxgame14	sounds/voice/default/koraxgame14.ogg
voice/default/koraxworship1	sounds/voice/default/koraxworship1.ogg
voice/default/koraxworship2	sounds/voice/default/koraxworship2.ogg
voice/default/koraxworship3	sounds/voice/default/koraxworship3.ogg
voice/default/koraxworship4	sounds/voice/default/koraxworship4.ogg
voice/default/koraxworship5	sounds/voice/default/koraxworship5.ogg
voice/default/koraxworship6	sounds/voice/default/koraxworship6.ogg
voice/default/koraxworship7	sounds/voice/default/koraxworship7.ogg
voice/default/koraxworship8	sounds/voice/default/koraxworship8.ogg
voice/default/koraxworship9	sounds/voice/default/koraxworship9.ogg
voice/default/koraxworship10	sounds/voice/default/koraxworship10.ogg
voice/default/koraxworship11	sounds/voice/default/koraxworship11.ogg
voice/default/koraxmasters1	sounds/voice/default/koraxmasters1.ogg
voice/default/koraxmasters2	sounds/voice/default/koraxmasters2.ogg
voice/default/koraxmasters3	sounds/voice/default/koraxmasters3.ogg
voice/default/koraxmasters4	sounds/voice/default/koraxmasters4.ogg
voice/default/koraxmasters5	sounds/voice/default/koraxmasters5.ogg
voice/default/koraxmasters6	sounds/voice/default/koraxmasters6.ogg
voice/default/koraxmasters7	sounds/voice/default/koraxmasters7.ogg
voice/default/koraxmasters8	sounds/voice/default/koraxmasters8.ogg
voice/default/koraxmasters9	sounds/voice/default/koraxmasters9.ogg

$random voice/default/grunt { voice/default/grunt1 voice/default/grunt2 voice/default/grunt3 voice/default/grunt4 voice/default/grunt5 voice/default/grunt6 }
$random voice/default/lopain { voice/default/lopain1 voice/default/lopain2 voice/default/lopain3 voice/default/lopain4 voice/default/lopain5 }
$random voice/default/pain { voice/default/pain1 voice/default/pain2 voice/default/pain3 voice/default/pain4 voice/default/pain5 }
$random voice/default/hipain { voice/default/hipain1 voice/default/hipain2 voice/default/hipain3 voice/default/hipain4 voice/default/hipain5 }
$random voice/default/death { voice/default/death1 voice/default/death2 voice/default/death3 voice/default/death4 voice/default/death5 }

demolitionist/walk1	sounds/demolitionist/demowalk1.ogg
demolitionist/walk2	sounds/demolitionist/demowalk2.ogg
demolitionist/walk3	sounds/demolitionist/demowalk3.ogg
demolitionist/walk4	sounds/demolitionist/demowalk4.ogg
$random demolitionist/walk { demolitionist/walk1 demolitionist/walk2 demolitionist/walk3 demolitionist/walk4 }
demolitionist/runstart1	sounds/demolitionist/demorunbeg1.ogg
demolitionist/runstart2	sounds/demolitionist/demorunbeg2.ogg
demolitionist/runstart3	sounds/demolitionist/demorunbeg3.ogg
demolitionist/runstart4	sounds/demolitionist/demorunbeg4.ogg
$random demolitionist/runstart { demolitionist/runstart1 demolitionist/runstart2 demolitionist/runstart3 demolitionist/runstart4 }
demolitionist/run1	sounds/demolitionist/demorun1.ogg
demolitionist/run2	sounds/demolitionist/demorun2.ogg
demolitionist/run3	sounds/demolitionist/demorun3.ogg
demolitionist/run4	sounds/demolitionist/demorun4.ogg
$random demolitionist/run { demolitionist/run1 demolitionist/run2 demolitionist/run3 demolitionist/run4 }
demolitionist/runstop1	sounds/demolitionist/demorunstp1.ogg
demolitionist/runstop2	sounds/demolitionist/demorunstp2.ogg
demolitionist/runstop3	sounds/demolitionist/demorunstp3.ogg
demolitionist/runstop4	sounds/demolitionist/demorunstp4.ogg
$random demolitionist/runstop { demolitionist/runstop1 demolitionist/runstop2 demolitionist/runstop3 demolitionist/runstop4 }
demolitionist/jet	sounds/demolitionist/demojet.ogg
demolitionist/jetstop	sounds/demolitionist/demojetstop.ogg
demolitionist/death1	sounds/demolitionist/demodeath1.ogg
demolitionist/death2	sounds/demolitionist/demodeath2.ogg
demolitionist/death3	sounds/demolitionist/demodeath3.ogg
$random demolitionist/death { demolitionist/death1 demolitionist/death2 demolitionist/death3 }
demolitionist/xdeath1	sounds/demolitionist/demoxdeath1.ogg
demolitionist/xdeath2	sounds/demolitionist/demoxdeath2.ogg
demolitionist/xdeath3	sounds/demolitionist/demoxdeath3.ogg
$random demolitionist/xdeath { demolitionist/xdeath1 demolitionist/xdeath2 demolitionist/xdeath3 }
demolitionist/wdeath1	sounds/demolitionist/demowdeath1.ogg
demolitionist/wdeath2	sounds/demolitionist/demowdeath2.ogg
demolitionist/wdeath3	sounds/demolitionist/demowdeath3.ogg
$random demolitionist/wdeath { demolitionist/wdeath1 demolitionist/wdeath2 demolitionist/wdeath3 }
demolitionist/pain1	sounds/demolitionist/demopain1.ogg
demolitionist/pain2	sounds/demolitionist/demopain2.ogg
demolitionist/pain3	sounds/demolitionist/demopain3.ogg
$random demolitionist/pain { demolitionist/pain1 demolitionist/pain2 demolitionist/pain3 }
demolitionist/hipain1	sounds/demolitionist/demohipain1.ogg
demolitionist/hipain2	sounds/demolitionist/demohipain2.ogg
demolitionist/hipain3	sounds/demolitionist/demohipain3.ogg
$random demolitionist/hipain { demolitionist/hipain1 demolitionist/hipain2 demolitionist/hipain3 }
demolitionist/lopain1	sounds/demolitionist/demolopain1.ogg
demolitionist/lopain2	sounds/demolitionist/demolopain2.ogg
demolitionist/lopain3	sounds/demolitionist/demolopain3.ogg
$random demolitionist/lopain { demolitionist/lopain1 demolitionist/lopain2 demolitionist/lopain3 }
demolitionist/hardland1	sounds/demolitionist/demohland1.ogg
demolitionist/hardland2	sounds/demolitionist/demohland2.ogg
demolitionist/hardland3	sounds/demolitionist/demohland3.ogg
$random demolitionist/hardland { demolitionist/hardland1 demolitionist/hardland2 demolitionist/hardland3 }
demolitionist/swing1	sounds/demolitionist/demoswing1.ogg
demolitionist/swing2	sounds/demolitionist/demoswing2.ogg
demolitionist/swing3	sounds/demolitionist/demoswing3.ogg
$random demolitionist/swing { demolitionist/swing1 demolitionist/swing2 demolitionist/swing3 }
demolitionist/wswing1	sounds/demolitionist/demowswing1.ogg
demolitionist/wswing2	sounds/demolitionist/demowswing2.ogg
$random demolitionist/wswing { demolitionist/wswing1 demolitionist/wswing2 }
demolitionist/punch1	sounds/demolitionist/demopunch1.ogg
demolitionist/punch2	sounds/demolitionist/demopunch2.ogg
demolitionist/punch3	sounds/demolitionist/demopunch3.ogg
$random demolitionist/punch { demolitionist/punch1 demolitionist/punch2 demolitionist/punch3 }
demolitionist/punchf1	sounds/demolitionist/demopunchf1.ogg
demolitionist/punchf2	sounds/demolitionist/demopunchf2.ogg
demolitionist/punchf3	sounds/demolitionist/demopunchf3.ogg
$random demolitionist/punchf { demolitionist/punchf1 demolitionist/punchf2 demolitionist/punchf3 }
demolitionist/bump1	sounds/demolitionist/demobump1.ogg
demolitionist/bump2	sounds/demolitionist/demobump2.ogg
demolitionist/bump3	sounds/demolitionist/demobump3.ogg
$random demolitionist/bump { demolitionist/bump1 demolitionist/bump2 demolitionist/bump3 }
demolitionist/kick1	sounds/demolitionist/demokick1.ogg
demolitionist/kick2	sounds/demolitionist/demokick2.ogg
demolitionist/kick3	sounds/demolitionist/demokick3.ogg
$random demolitionist/kick { demolitionist/kick1 demolitionist/kick2 demolitionist/kick3 }
demolitionist/revive	sounds/demolitionist/demorevive.ogg
demolitionist/youdied	sounds/demolitionist/demoded.ogg

$playersound demolitionist neutral *grunt	DSEMPTY
$playeralias demolitionist neutral *pain100	demolitionist/lopain
$playeralias demolitionist neutral *pain75	demolitionist/pain
$playeralias demolitionist neutral *pain50	demolitionist/pain
$playeralias demolitionist neutral *pain25	demolitionist/hipain
$playersound demolitionist neutral *usefail	sounds/menu/failuse.ogg
$playeralias demolitionist neutral *death	demolitionist/death
$playeralias demolitionist neutral *burndeath	demolitionist/death
$playeralias demolitionist neutral *xdeath	demolitionist/xdeath
$playeralias demolitionist neutral *gibbed	demolitionist/xdeath
$playeralias demolitionist neutral *crazydeath	demolitionist/xdeath
$playeralias demolitionist neutral *wimpydeath	demolitionist/wdeath
$playersound demolitionist neutral *land	DSEMPTY
$playersound demolitionist neutral *falling	DSEMPTY
$playersound demolitionist neutral *puzzfail	sounds/menu/failuse.ogg
$playersound demolitionist neutral *poison	DSEMPTY
$playersound demolitionist neutral *dive	DSEMPTY
$playersound demolitionist neutral *surface	DSEMPTY
$playersound demolitionist neutral *gasp	DSEMPTY
$playersound demolitionist neutral *taunt	DSEMPTY
$playersound demolitionist neutral *evillaugh	DSEMPTY

deepimpact/fire		sounds/deepimpact/impfire.ogg
deepimpact/charge	sounds/deepimpact/impaltcharge.ogg
deepimpact/altfire	sounds/deepimpact/impaltfire.ogg
deepimpact/dryfire	sounds/deepimpact/impdryfire.ogg
deepimpact/select	sounds/deepimpact/impsel.ogg
deepimpact/checkout	sounds/deepimpact/impidle.ogg
deepimpact/deselect	sounds/deepimpact/impdown.ogg
deepimpact/bullet	sounds/deepimpact/impbulletfly.ogg
deepimpact/bullethit1	sounds/deepimpact/impexplo1.ogg
deepimpact/bullethit2	sounds/deepimpact/impexplo2.ogg
deepimpact/reloadbeg	sounds/deepimpact/impreloadstart.ogg
deepimpact/reloadend	sounds/deepimpact/impreloadend.ogg
deepimpact/reload	sounds/deepimpact/impcrank.ogg
deepimpact/noreload	sounds/deepimpact/impcrankhalt.ogg
$random deepimpact/bullethit { deepimpact/bullethit1 deepimpact/bullethit2 }

explodium/casing1	sounds/explodiumgun/expl_case1.ogg
explodium/casing2	sounds/explodiumgun/expl_case2.ogg
explodium/casing3	sounds/explodiumgun/expl_case3.ogg
explodium/casing4	sounds/explodiumgun/expl_case4.ogg
$random explodium/casing { explodium/casing1 explodium/casing2 explodium/casing3 explodium/casing4 }
explodium/checkout	sounds/explodiumgun/expl_checkout.ogg
explodium/fire1		sounds/explodiumgun/expl_fire1.ogg
explodium/fire2		sounds/explodiumgun/expl_fire2.ogg
explodium/fire3		sounds/explodiumgun/expl_fire3.ogg
$random explodium/fire { explodium/fire1 explodium/fire2 explodium/fire3 }
explodium/hit1		sounds/explodiumgun/expl_hit1.ogg
explodium/hit2		sounds/explodiumgun/expl_hit2.ogg
explodium/hit3		sounds/explodiumgun/expl_hit3.ogg
$random explodium/hit { explodium/hit1 explodium/hit2 explodium/hit3 }
explodium/jamitin	sounds/explodiumgun/expl_jamitin.ogg
explodium/mag1		sounds/explodiumgun/expl_mag1.ogg
explodium/mag2		sounds/explodiumgun/expl_mag2.ogg
explodium/mag3		sounds/explodiumgun/expl_mag3.ogg
$random explodium/mag { explodium/mag1 explodium/mag2 explodium/mag3 }
explodium/maghit1	sounds/explodiumgun/expl_maghit1.ogg
explodium/maghit2	sounds/explodiumgun/expl_maghit2.ogg
$random explodium/maghit { explodium/maghit1 explodium/maghit2 }
explodium/magin		sounds/explodiumgun/expl_magin.ogg
explodium/magout	sounds/explodiumgun/expl_magout.ogg
explodium/magpin	sounds/explodiumgun/expl_magpin.ogg
explodium/select	sounds/explodiumgun/expl_select.ogg
explodium/deselect	sounds/explodiumgun/expl_deselect.ogg
explodium/slideback	sounds/explodiumgun/expl_slideback.ogg
explodium/slideforward	sounds/explodiumgun/expl_slideforward.ogg
explodium/speen		sounds/explodiumgun/expl_speen.ogg
explodium/throwmag	sounds/explodiumgun/expl_throwmag.ogg
$limit explodium/hit 32
$limit explodium/maghit 32

pusher/select	sounds/pusher/push_select.ogg
pusher/deselect	sounds/pusher/push_deselect.ogg
pusher/motor	sounds/pusher/push_motor.ogg
pusher/motorend	sounds/pusher/push_motorend.ogg
pusher/start	sounds/pusher/push_start.ogg
pusher/drill	sounds/pusher/push_drill.ogg
pusher/hit1	sounds/pusher/push_hitw1.ogg
pusher/hit2	sounds/pusher/push_hitw2.ogg
pusher/hit3	sounds/pusher/push_hitw3.ogg
$random pusher/hit { pusher/hit1 pusher/hit2 pusher/hit3 }
$limit pusher/hit 32
pusher/meat1	sounds/pusher/push_hitf1.ogg
pusher/meat2	sounds/pusher/push_hitf2.ogg
pusher/meat3	sounds/pusher/push_hitf3.ogg
$random pusher/meat { pusher/meat1 pusher/meat2 pusher/meat3 }
$limit pusher/meat 32
pusher/end	sounds/pusher/push_end.ogg
pusher/checkout	sounds/pusher/push_idle.ogg
pusher/pullback	sounds/pusher/push_altcharge.ogg
pusher/altfire1	sounds/pusher/push_altfire1.ogg
pusher/altfire2	sounds/pusher/push_altfire2.ogg
$random pusher/altfire { pusher/altfire1 pusher/altfire2 }
pusher/miss	sounds/pusher/push_miss.ogg
pusher/althit1	sounds/pusher/push_slam1.ogg
pusher/althit2	sounds/pusher/push_slam2.ogg
$random pusher/althit { pusher/althit1 pusher/althit2 }
pusher/altmeat1	sounds/pusher/push_slamf1.ogg
pusher/altmeat2	sounds/pusher/push_slamf2.ogg
$random pusher/altmeat { pusher/altmeat1 pusher/altmeat2 }
pusher/fly	sounds/pusher/push_fly.ogg
pusher/bounce1	sounds/pusher/push_bounce1.ogg
pusher/bounce2	sounds/pusher/push_bounce2.ogg
pusher/bounce3	sounds/pusher/push_bounce3.ogg
$random pusher/bounce { pusher/bounce1 pusher/bounce2 pusher/bounce3 }

spreadgun/open		sounds/spreadgun/spread_open.ogg
spreadgun/hammer	sounds/spreadgun/spread_hammer.ogg
spreadgun/close		sounds/spreadgun/spread_close.ogg
spreadgun/shellin	sounds/spreadgun/spread_load.ogg
spreadgun/select	sounds/spreadgun/spread_select.ogg
spreadgun/deselect	sounds/spreadgun/spread_deselect.ogg
spreadgun/redfire1	sounds/spreadgun/spread_redfire1.ogg
spreadgun/redfire2	sounds/spreadgun/spread_redfire2.ogg
$random spreadgun/redfire { spreadgun/redfire1 spreadgun/redfire2 }
spreadgun/greenfire1	sounds/spreadgun/spread_greenfire1.ogg
spreadgun/greenfire2	sounds/spreadgun/spread_greenfire2.ogg
$random spreadgun/greenfire { spreadgun/greenfire1 spreadgun/greenfire2 }
spreadgun/whitefire1	sounds/spreadgun/spread_whitefire1.ogg
spreadgun/whitefire2	sounds/spreadgun/spread_whitefire2.ogg
$random spreadgun/whitefire { spreadgun/whitefire1 spreadgun/whitefire2 }
spreadgun/bluefire1	sounds/spreadgun/spread_bluefire1.ogg
spreadgun/bluefire2	sounds/spreadgun/spread_bluefire2.ogg
$random spreadgun/bluefire { spreadgun/bluefire1 spreadgun/bluefire2 }
spreadgun/blackfire1	sounds/spreadgun/spread_blackfire1.ogg
spreadgun/blackfire2	sounds/spreadgun/spread_blackfire2.ogg
$random spreadgun/blackfire { spreadgun/blackfire1 spreadgun/blackfire2 }
spreadgun/purplefire1	sounds/spreadgun/spread_purplefire1.ogg
spreadgun/purplefire2	sounds/spreadgun/spread_purplefire2.ogg
$random spreadgun/purplefire { spreadgun/purplefire1 spreadgun/purplefire2 }
spreadgun/goldfire1	sounds/spreadgun/spread_goldfire1.ogg
spreadgun/goldfire2	sounds/spreadgun/spread_goldfire2.ogg
$random spreadgun/goldfire { spreadgun/goldfire1 spreadgun/goldfire2 }
spreadgun/checkgun	sounds/spreadgun/spread_idle.ogg
spreadgun/casing1	sounds/spreadgun/spread_casing1.ogg
spreadgun/casing2	sounds/spreadgun/spread_casing2.ogg
spreadgun/casing3	sounds/spreadgun/spread_casing3.ogg
spreadgun/casing4	sounds/spreadgun/spread_casing4.ogg
spreadgun/casing5	sounds/spreadgun/spread_casing5.ogg
spreadgun/casing6	sounds/spreadgun/spread_casing6.ogg
$random spreadgun/casing { spreadgun/casing1 spreadgun/casing2 spreadgun/casing3 spreadgun/casing4 spreadgun/casing5 spreadgun/casing6 }
spreadgun/gcasing1	sounds/spreadgun/spread_gcasing1.ogg
spreadgun/gcasing2	sounds/spreadgun/spread_gcasing2.ogg
spreadgun/gcasing3	sounds/spreadgun/spread_gcasing3.ogg
$random spreadgun/gcasing { spreadgun/gcasing1 spreadgun/gcasing2 spreadgun/gcasing3 }
spreadgun/pellet1	sounds/spreadgun/spread_pellet1.ogg
spreadgun/pellet2	sounds/spreadgun/spread_pellet2.ogg
spreadgun/pellet3	sounds/spreadgun/spread_pellet3.ogg
spreadgun/pellet4	sounds/spreadgun/spread_pellet4.ogg
spreadgun/pellet5	sounds/spreadgun/spread_pellet5.ogg
spreadgun/pellet6	sounds/spreadgun/spread_pellet6.ogg
spreadgun/pellet7	sounds/spreadgun/spread_pellet7.ogg
spreadgun/pellet8	sounds/spreadgun/spread_pellet8.ogg
$random spreadgun/pellet { spreadgun/pellet1 spreadgun/pellet2 spreadgun/pellet3 spreadgun/pellet4 spreadgun/pellet5 spreadgun/pellet6 spreadgun/pellet7 spreadgun/pellet8 }
$limit spreadgun/pellet 32
spreadgun/pelletf1	sounds/spreadgun/spread_pelletf1.ogg
spreadgun/pelletf2	sounds/spreadgun/spread_pelletf2.ogg
spreadgun/pelletf3	sounds/spreadgun/spread_pelletf3.ogg
spreadgun/pelletf4	sounds/spreadgun/spread_pelletf4.ogg
spreadgun/pelletf5	sounds/spreadgun/spread_pelletf5.ogg
spreadgun/pelletf6	sounds/spreadgun/spread_pelletf6.ogg
$random spreadgun/pelletf { spreadgun/pelletf1 spreadgun/pelletf2 spreadgun/pelletf3 spreadgun/pelletf4 spreadgun/pelletf5 spreadgun/pelletf6 }
$limit spreadgun/pelletf 32
spreadgun/slug1		sounds/spreadgun/spread_slug1.ogg
spreadgun/slug2		sounds/spreadgun/spread_slug2.ogg
$random spreadgun/slug { spreadgun/slug1 spreadgun/slug2 }
spreadgun/slugf1	sounds/spreadgun/spread_slugf1.ogg
spreadgun/slugf2	sounds/spreadgun/spread_slugf2.ogg
$random spreadgun/slugf { spreadgun/slugf1 spreadgun/slugf2 }
spreadgun/ball1		sounds/spreadgun/spread_ball1.ogg
spreadgun/ball2		sounds/spreadgun/spread_ball2.ogg
spreadgun/ball3		sounds/spreadgun/spread_ball3.ogg
$random spreadgun/ball { spreadgun/ball1 spreadgun/ball2 spreadgun/ball3 }
spreadgun/ballf1	sounds/spreadgun/spread_ballf1.ogg
spreadgun/ballf2	sounds/spreadgun/spread_ballf2.ogg
spreadgun/ballf3	sounds/spreadgun/spread_ballf3.ogg
$random spreadgun/ballf { spreadgun/ballf1 spreadgun/ballf2 spreadgun/ballf3 }
spreadgun/salt1		sounds/spreadgun/spread_salt1.ogg
spreadgun/salt2		sounds/spreadgun/spread_salt2.ogg
spreadgun/salt3		sounds/spreadgun/spread_salt3.ogg
spreadgun/salt4		sounds/spreadgun/spread_salt4.ogg
$random spreadgun/salt { spreadgun/salt1 spreadgun/salt2 spreadgun/salt3 spreadgun/salt4 }
$limit spreadgun/salt 32
spreadgun/salttrail1	sounds/spreadgun/spread_bluetrail1.ogg
spreadgun/salttrail2	sounds/spreadgun/spread_bluetrail2.ogg
spreadgun/salttrail3	sounds/spreadgun/spread_bluetrail3.ogg
spreadgun/salttrail4	sounds/spreadgun/spread_bluetrail4.ogg
$random spreadgun/salttrail { spreadgun/salttrail1 spreadgun/salttrail2 spreadgun/salttrail3 spreadgun/salttrail4 }
$limit spreadgun/salttrail 32

candygun/fire1		sounds/candygun/candy_fire1.ogg
candygun/fire2		sounds/candygun/candy_fire2.ogg
candygun/fire3		sounds/candygun/candy_fire3.ogg
$random candygun/fire { candygun/fire1 candygun/fire2 candygun/fire3 }
candygun/hit1		sounds/candygun/candy_hit1.ogg
candygun/hit2		sounds/candygun/candy_hit2.ogg
candygun/hit3		sounds/candygun/candy_hit3.ogg
$random candygun/hit { candygun/hit1 candygun/hit2 candygun/hit3 }
candygun/maghit1	sounds/candygun/candy_maghit1.ogg
candygun/maghit2	sounds/candygun/candy_maghit2.ogg
$random candygun/maghit { candygun/maghit1 candygun/maghit2 }
candygun/gunhit1	sounds/candygun/candy_gunhit1.ogg
candygun/gunhit2	sounds/candygun/candy_gunhit2.ogg
$random candygun/gunhit { candygun/gunhit1 candygun/gunhit2 }
$limit candygun/hit 32
$limit candygun/maghit 32
$limit candygun/gunhit 32

chancebox/explode1	sounds/items/lootexpl1.ogg
chancebox/explode2	sounds/items/lootexpl2.ogg
chancebox/explode3	sounds/items/lootexpl3.ogg
$random chancebox/explode { chancebox/explode1 chancebox/explode2 chancebox/explode3 }
chancebox/land1		sounds/items/lootland1.ogg
chancebox/land2		sounds/items/lootland2.ogg
chancebox/land3		sounds/items/lootland3.ogg
$random chancebox/land { chancebox/land1 chancebox/land2 chancebox/land3 }
chancebox/drumroll	sounds/DRUMROLL.ogg
chancebox/tada		sounds/TADA.ogg

misc/secret		sounds/menu/findsecret.ogg
misc/keytry		sounds/menu/failuse.ogg
misc/w_pkup		sounds/general/wpickup.ogg
misc/p_pkup		sounds/general/ppickup.ogg
misc/i_pkup		sounds/general/ipickup.ogg
misc/k_pkup		sounds/general/kpickup.ogg
misc/ammo_pkup		sounds/general/apickup.ogg
misc/armor_pkup		sounds/general/spickup.ogg
misc/health_pkup	sounds/general/hpickup.ogg
misc/spawn		sounds/CORK.ogg
misc/teleport		sounds/general/teleport.ogg
misc/chat		sounds/menu/chatsnd.ogg
misc/chat2		sounds/menu/chatsnd.ogg
misc/sundowner		sounds/SUNDOWNER.ogg

misc/underwater	sounds/general/uWater1a.ogg
misc/underslime	sounds/general/uGoop1.ogg
misc/underlava	sounds/general/uLava1.ogg
misc/waterenter	sounds/general/DIVE.ogg
misc/slimeenter	sounds/general/GoopJ1.ogg
misc/lavaenter	sounds/general/LavaJ1.ogg
misc/waterexit	sounds/general/surfaceb.ogg
misc/slimeexit	sounds/general/GoopE1.ogg
misc/lavaexit	sounds/general/LavaE1.ogg

armor/blastsuit	sounds/items/blastsuit.ogg
armor/wararmor	sounds/items/wararmor.ogg
armor/hit1	sounds/items/hullhit.ogg
armor/hit2	sounds/items/hullhit2.ogg
armor/hit3	sounds/items/hullhit3.ogg
armor/hit4	sounds/items/hullhit4.ogg
armor/hit5	sounds/items/hullhit5.ogg
$random armor/hit { armor/hit1 armor/hit2 armor/hit3 armor/hit4 armor/hit5 }

powerup/refresher	sounds/items/refresh.ogg
powerup/sandwich	sounds/CORK.ogg
powerup/ghost		sounds/items/CloakOn.ogg
powerup/ghostact	sounds/items/CloakLoop3.ogg
powerup/ghostend	sounds/items/CloakOff.ogg
powerup/gravity		sounds/items/gravityon.ogg
powerup/gravityact	sounds/items/gravityact.ogg
powerup/gravityend	sounds/items/gravityoff.ogg
powerup/invinciball	sounds/items/invincion.ogg
powerup/invinciballact	sounds/items/invinciact.ogg
powerup/invinciballhit	sounds/items/invincihit.ogg
powerup/invinciballend	sounds/items/invincioff.ogg
powerup/ragekit		sounds/items/ragekiton.ogg
powerup/ragekitact	sounds/items/ragekitact.ogg
powerup/ragekithit	sounds/items/ragekithit.ogg
powerup/ragekitend	sounds/items/ragekitoff.ogg
powerup/omnisight	sounds/items/omnisight.ogg
powerup/embiggener	sounds/items/embiggen.ogg

lamp/on		sounds/items/lampon.ogg
lamp/off	sounds/items/lampoff.ogg
lamp/appear	sounds/items/lampappear.ogg
lamp/disappear	sounds/items/lampdisappear.ogg
// maybe eventually
//mashiro/see		(some sort of creepy yandere girl giggling I guess)
//mashiro/active	(more creepy giggles?)
//mashiro/attack	(clawing)
moth/scrape1	sounds/items/mothatk1.ogg
moth/scrape2	sounds/items/mothatk2.ogg
moth/scrape3	sounds/items/mothatk3.ogg
moth/scrape4	sounds/items/mothatk4.ogg
$random moth/scrape { moth/scrape1 moth/scrape2 moth/scrape3 moth/scrape4 }
$limit moth/scrape 30
moth/die1	sounds/items/mothdie1.ogg
moth/die2	sounds/items/mothdie2.ogg
$random moth/die { moth/die1 moth/die2 }
moth/fly	sounds/items/mothfly.ogg
$limit moth/fly 30

fabricator/use	sounds/items/makeammo.ogg

menu/activate	sounds/hmenu/hmenu1.ogg
menu/backup	sounds/hmenu/hmenu2.ogg
menu/prompt	sounds/hmenu/hmenu1.ogg
menu/cursor	sounds/hmenu/hmenu1.ogg
menu/change	sounds/hmenu/hmenu1.ogg
menu/invalid	sounds/hmenu/hmenu2.ogg
menu/dismiss	sounds/hmenu/hmenu2.ogg
menu/choose	sounds/hmenu/hmenu1.ogg
menu/clear	sounds/hmenu/hmenu2.ogg

menu/demoopen	sounds/menu/openkbase.ogg
menu/demotab	sounds/menu/menutab.ogg
menu/demosel	sounds/menu/menuset.ogg
menu/demoscroll	sounds/menu/menuscroll.ogg
menu/democlose	sounds/menu/menuclose.ogg

menu/fail	sounds/menu/failuse.ogg
menu/noinvuse	sounds/menu/failinv.ogg
menu/buyinv	sounds/menu/buysnd.ogg

$alias misc/invchange menu/demosel
UseArtifact	DSEMPTY
